,a,b,c,d,e,f,g,h,i,j,k,l,m,n
1,0,0,0,0,0,0,0,0,0,0,0,0,1,1
2,0,0,0,0,0,0,0,0,0,0,0,0,1,1
3,0,0,0,0,0,0,0,0,0,0,0,0,1,1
4,0,0,0,0,0,0,0,0,0,0,0,0,1,1
5,0,0,0,0,0,0,0,0,0,0,0,0,1,1
6,0,0,0,0,0,0,0,0,0,0,0,0,1,1
7,0,0,0,0,0,0,0,0,0,0,0,0,1,1
8,0,0,0,0,0,0,0,0,0,0,0,0,1,1
9,0,0,0,0,0,0,0,0,3,0,0,0,1,1
10,0,0,0,0,0,0,0,0,2,0,0,0,1,1
11,0,0,0,0,0,0,0,0,0,0,0,0,1,1
12,0,0,0,0,0,0,0,0,0,0,0,0,1,1
13,0,0,0,0,0,0,0,0,0,0,0,0,1,1
14,0,0,0,0,0,0,0,0,0,0,0,0,1,1
15,0,0,0,0,0,0,0,0,0,0,0,0,1,1
16,0,0,0,0,0,0,0,0,0,0,0,0,1,1
17,0,0,0,0,0,0,0,0,0,0,0,0,1,1
18,0,0,0,0,0,0,0,0,0,0,0,0,1,1
19,0,0,0,0,0,0,0,0,0,0,0,0,1,1
20,0,0,0,0,0,0,0,0,0,0,0,0,1,1
21,0,0,0,0,0,0,0,0,0,0,0,0,1,1
22,0,0,0,0,0,0,0,0,0,0,0,0,1,1
23,0,0,0,0,0,0,0,0,0,0,0,0,1,1
24,0,0,0,0,0,0,0,0,0,0,0,0,1,1
25,0,0,0,0,0,0,0,0,0,0,0,0,1,1
26,0,0,0,0,0,0,0,0,0,0,0,0,1,1
